0000000000000000000000000
0111011111110111110111000
0001010001010100010101000
0111010111020111011101000
0100010100000100000001000
0101110111111101111101000
0100000000000001000101000
0111111101111101110111000
0000000101000100010001000
0101110101010111110101000
0101010101010000000101000
0111010111010111111101000
0000010000010100000101000
0111111301111101111101000
0100000001000001000001000
0111111111011111011111000
0100000000010000010000000
0111111101110111110111000
0000000101000100000100000
0111111101110101110111000
0000000000010100010101000
0111111111110111011101000
0100000000000001000001000
0111111111111111111111000
0000000000000000000000000
