########################
#   #       #     #   ##
### # ### # # ### # # ##
#   # #   #S#   #   # ##
# ### # ##### ####### ##
# #   #       #     # ##
# ############# ### # ##
#       #     #   #   ##
####### # ### ### ### ##
# #   # # # #     # # ##
# # # # # # ####### # ##
#   # #   # #       # ##
##### ##### # ##### # ##
#      E#     #     # ##
# ####### ##### ##### ##
#         #     #     ##
# ######### ##### ######
#       #   #     #   ##
####### # ### ##### ####
#       #   # #   #   ##
########### # ### # # ##
#           #   #   # ##
# ############# ##### ##
#                     ##
########################





